ransarmtuhit	person
bemulkitmon	thing
temtcanpahbac	place
macigwakdjik	time
mahbilwanhoc	want
patwelazbek	should
meshalazkan	must
dapsuwezdek	able
perpirhithit	need
fitkokikag	mirror
sincinkacin	sink
katcimkitbed	bed
tintcandirmad	window
raksonraftan	shelf
metcekdawtsuk	desk
lanpadsakyuk	floor
kunamimwat	I
nkawnowewnat	you
diguyeykar	he
kitrisiswat	we
kanohninat	youall
mergudwakar	they
nihikor	this
tugulere	that
sinyoghapkok	here
sitgogpalsok	there
sinugnandar	who
pamwotninan	what
mandiwapdok	where
bilndjelintsu	when
bagtokvipkag	how
tidnisina	not
semotesub	all
bamangoi	many
bebtonbadsuk	some
setcokidsuk	few
ladarnginhok	other
sathamodhit	one
dudulmbilfut	two
tigsetatmit	three
mpatnetneyot	four
limdastantsut	five
beskukubki	big
pangirefnag	long
lebnolpanhir	wide
tebduknentsu	thick
bermugzitmo	heavy
kedjakdogtcis	small
pendjalfupmid	short
semdjopmbamsem	narrow
nipyalnanhos	thin
peryodmwana	woman
lelnamwantok	man
ransarmtuhit	human
nakrimtotko	child
sternemketsum	wife
sunamumto	husband
bumomamhah	mother
babodbabtcit	father
bindjimnyamkem	animal
kamulsamuo	fish
bursendegtor	bird
ndjingembwanu	dog
kutitcawcir	louse
larbenyokheb	snake
tcatbolfumim	worm
poknamtiki	tree
hutsupmsitmor	forest
batmakfimtsu	stick
buyoltunkud	fruit
bencimbegtan	seed
dipdjanha	leaf
karpurmzizne	root
kulkopgamdjuh	bark
bunkotuahan	flower
rumpulnyaskus	grass
talbatkanaw	rope
kulsalngozkaw	skin
dagsalnyanik	meat
darpidamtci	blood
tulpyomfuphon	bone
lemgirmorbur	fat
telalyatam	egg
tanpulpemtsun	horn
korkormko	tail
bulgitnyoyhan	feather
ramtolnywelkam	hair
kepmorkitam	head
telgwisikmim	ear
matnundjitme	eye
hidkopuhan	nose
mulipkinkut	mouth
gigidjinha	tooth
lidhyolimcit	tongue
kuksonkutsum	fingernail
kakbalmguci	foot
kakdarmguci	leg
lutmurgothiz	knee
tansomkonte	hand
saynalbawtsub	wing
perbetumhar	belly
